11111111111111111111
1P0000000000000000C1
10E000000000C0000001
10000000000000000001
10000000000000000001
10000000000000000001
10000000100000100001
10000000000000000001
1000000C000000000001
10000000000000000001
10000000000000000001
11111111111111111111
